16 16 16 16 16 16 16 16 16 16 16 16 16 16 16 16 16 16 16 16 16 16 16 16 16 16 16 16 16 16 16 16 16 16 16 16 16 16 16 16 16 16 16 16 16 16 16 16 16 16
16 16 16 16 16 16 16 16 16 16 16 16 16 16 16 16 16 16 16 16 13 13 13 13 16 16 16 13 13 16 16 16 13 16 16 16 16 16 16 16 16 16 16 16 16 16 16 16 16 16
16 16 16 16 16 13 13 13 13 13 13 13 13 13 13 13 13 13 16 13 13 13 13 13 13 13 13 16 13 16 13 13 13 16 16 16 16 16 16 16 16 16 16 16 16 16 16 16 16 16
16 16 16 16 16 13 0 0 0 0 0 0 0 13 13 0 0 13 13 13 13 13 13 13 13 16 13 13 13 13 13 13 13 16 16 16 16 16 16 16 16 16 16 16 16 16 16 16 16 16
16 16 16 16 13 13 1 1 1 1 1 1 1 1 0 0 0 0 0 1 1 1 0 1 1 1 1 1 1 0 0 0 13 16 16 16 16 16 16 16 16 16 16 16 16 16 16 16 16 16
16 16 16 16 13 0 1 0 0 0 0 0 0 1 1 1 1 1 1 0 0 0 1 0 0 0 0 0 1 1 1 0 13 16 16 16 16 16 16 16 16 16 16 16 16 16 16 16 16 16
16 16 16 16 13 0 1 0 0 0 0 0 0 0 0 0 0 0 0 0 0 1 0 0 0 0 0 0 0 0 1 0 13 16 16 16 16 16 16 16 16 16 16 16 16 16 16 16 16 16
16 16 16 16 13 0 1 0 0 0 0 0 0 0 1 0 0 0 0 0 0 1 0 0 0 0 0 0 0 0 1 0 13 16 16 16 16 16 16 16 16 16 16 16 16 16 16 16 16 16
16 16 16 16 13 0 1 0 0 1 0 0 1 0 1 0 1 0 0 0 0 1 0 0 1 1 1 1 1 1 1 1 13 16 16 16 16 16 16 16 16 16 16 16 16 16 16 16 16 16
16 16 16 16 13 0 1 0 0 1 0 0 1 0 1 0 1 0 0 0 0 0 0 0 0 1 0 0 1 0 1 0 13 16 16 16 16 16 16 16 16 16 16 16 16 16 16 16 16 16
16 16 16 16 13 0 1 1 1 1 0 0 1 0 1 0 1 0 0 0 0 1 1 1 0 1 0 0 1 0 1 0 13 16 16 16 16 16 16 16 16 16 16 16 16 16 16 16 16 16
16 16 16 16 13 0 1 0 0 0 0 1 1 0 1 0 1 1 1 1 0 0 0 0 0 0 0 1 1 0 1 0 13 16 16 16 16 16 16 16 16 16 16 16 16 16 16 16 16 16
16 16 16 16 13 0 1 0 0 0 0 0 0 0 1 1 1 13 13 0 0 1 0 0 0 1 0 0 0 0 1 13 13 16 16 16 16 16 16 16 16 16 16 16 16 16 16 16 16 16
16 16 16 13 13 0 1 1 1 1 1 0 0 0 0 0 0 0 13 0 0 1 0 0 0 0 0 0 1 1 1 13 16 16 16 16 16 16 16 16 16 16 16 16 16 16 16 16 16 16
16 16 16 13 13 0 0 0 1 0 0 0 1 1 0 0 0 1 1 1 0 1 13 13 13 13 13 0 1 0 0 13 13 13 16 16 16 16 16 16 16 16 16 16 16 16 16 16 16 16
16 16 16 13 13 0 0 0 1 0 0 0 1 0 0 1 1 13 13 1 13 1 0 0 0 0 13 0 1 1 1 13 13 13 16 16 16 16 16 16 16 16 16 16 16 16 16 16 16 16
16 16 16 13 13 0 0 0 1 0 0 0 1 1 0 0 0 0 0 1 0 1 1 1 0 0 13 0 0 0 1 0 13 13 16 16 16 16 16 16 16 16 16 16 16 16 16 16 16 16
16 16 16 16 13 0 0 1 1 1 1 1 1 1 1 1 1 1 1 1 0 1 0 0 0 0 13 1 1 1 1 0 13 13 16 16 16 16 16 16 16 16 16 16 16 16 16 16 16 16
16 16 16 16 13 0 0 0 0 0 0 13 13 13 13 13 0 18 17 17 17 19 1 1 1 1 0 13 0 0 1 0 13 13 16 16 16 16 16 16 16 16 16 16 16 16 16 16 16 16
16 16 16 16 16 13 13 13 13 13 13 13 13 13 13 13 0 20 16 16 16 21 0 0 25 1 13 13 0 0 1 1 0 13 16 16 16 16 16 16 16 16 16 16 16 16 16 16 16 16
16 16 16 16 16 16 16 16 16 16 16 16 16 16 16 13 0 20 16 16 16 21 0 0 0 1 1 1 1 0 0 1 0 13 16 16 16 16 16 16 16 16 16 16 16 16 16 16 16 16
16 16 16 16 16 16 16 16 16 16 16 16 16 16 16 13 0 23 22 22 22 24 0 13 0 0 0 0 1 0 0 1 0 13 16 16 16 16 16 16 16 16 16 16 16 16 16 16 16 16
16 16 16 16 16 16 16 16 16 16 16 16 16 16 16 13 0 0 0 0 0 0 0 13 13 0 0 0 1 0 0 1 0 13 13 16 16 16 16 16 16 16 16 16 16 16 16 16 16 16
16 16 16 16 16 16 16 16 16 16 16 16 16 16 16 13 13 13 13 13 13 13 13 13 13 0 0 0 0 0 11 0 0 0 13 16 16 16 16 16 16 16 16 16 16 16 16 16 16 16
16 16 16 16 16 16 16 16 16 16 16 16 16 16 16 16 16 16 16 16 16 16 16 16 13 13 13 13 13 13 13 13 13 13 13 16 16 16 16 16 16 16 16 16 16 16 16 16 16 16
16 16 16 16 16 16 16 16 16 16 16 16 16 16 16 16 16 16 16 16 16 16 16 16 16 16 16 16 16 16 16 16 16 16 16 16 16 16 16 16 16 16 16 16 16 16 16 16 16 16
16 16 16 16 16 16 16 16 16 16 16 16 16 16 16 16 16 16 16 16 16 16 16 16 16 16 16 16 16 16 16 16 16 16 16 16 16 16 16 16 16 16 16 16 16 16 16 16 16 16
16 16 16 13 13 13 13 13 13 13 13 13 13 13 13 13 16 16 13 13 13 13 13 13 13 13 13 16 16 16 16 16 16 16 16 16 16 16 16 16 16 16 16 16 16 16 16 16 16 16
16 16 16 13 0 0 13 13 13 13 13 13 13 13 13 13 13 13 13 13 0 0 13 0 0 0 13 16 16 16 16 16 16 16 16 16 16 16 16 16 16 16 16 16 16 16 16 16 16 16
16 16 16 13 0 0 0 0 0 0 0 0 0 0 0 0 0 0 0 0 0 0 0 0 0 0 0 13 16 16 16 16 16 16 16 16 16 16 16 16 16 16 16 16 16 16 16 16 16 16
16 16 16 13 0 0 0 0 0 0 0 0 0 0 0 0 0 0 0 0 0 0 0 0 0 0 0 13 16 16 16 16 16 16 16 16 16 16 16 16 16 16 16 16 16 16 16 16 16 16
16 16 16 13 0 0 0 0 0 0 0 0 0 0 0 0 0 0 0 0 0 0 0 0 0 0 0 0 13 16 16 16 16 16 16 16 16 16 16 16 16 13 13 16 16 16 16 16 16 16
16 16 16 13 0 0 0 0 0 0 0 0 0 0 0 0 0 0 0 0 0 0 0 0 0 0 0 0 13 16 16 16 16 16 16 16 16 16 16 16 13 13 0 13 13 13 13 13 16 16
16 16 16 13 0 0 0 0 0 0 0 0 0 0 0 0 0 0 0 0 0 0 0 0 0 0 0 0 13 16 16 16 16 16 16 16 16 16 16 13 0 0 0 0 0 0 0 13 13 16
16 16 16 13 13 0 0 0 0 0 0 0 0 0 0 0 0 0 0 0 0 0 0 0 0 0 0 0 13 16 16 16 16 16 16 16 16 16 16 13 0 0 18 17 17 17 19 0 13 16
16 16 16 16 13 0 0 0 0 0 0 0 0 0 0 0 0 0 0 0 0 0 0 0 0 0 0 13 13 13 16 16 16 16 16 16 16 16 16 13 0 0 20 16 16 16 21 0 13 16
16 16 16 16 13 0 0 0 0 0 0 0 0 0 0 0 0 0 0 0 0 0 0 0 0 0 0 0 0 13 16 16 16 16 16 16 16 16 16 13 0 0 20 16 16 16 21 0 13 16
16 16 16 16 13 0 0 0 0 0 0 0 0 0 0 0 0 0 0 0 0 0 0 0 0 0 0 0 0 13 16 16 16 16 16 16 16 16 16 13 0 0 20 16 16 16 21 0 13 16
16 16 16 16 13 0 0 0 0 0 0 0 0 0 0 0 0 0 0 0 0 0 0 0 0 0 0 0 0 13 16 16 16 16 16 16 16 16 16 13 0 0 23 22 22 22 24 0 13 16
16 16 16 16 13 0 0 0 0 0 0 0 0 0 0 0 0 0 0 0 0 0 0 0 0 0 0 0 0 13 16 16 16 16 16 16 16 16 16 13 13 0 0 0 0 0 0 0 13 16
16 16 16 16 13 13 0 0 0 0 0 0 0 0 0 0 0 0 0 0 0 0 0 0 0 0 0 0 0 13 16 16 16 16 16 16 16 16 16 16 13 13 13 13 13 0 0 0 16 16
16 16 16 16 13 0 0 0 0 0 0 0 0 0 0 0 0 0 0 0 0 0 0 0 0 0 0 0 0 13 16 16 16 16 16 16 16 16 16 16 16 16 16 16 13 13 13 13 16 16
16 16 16 16 13 0 0 0 0 0 0 0 0 0 0 0 0 0 0 0 0 0 0 0 0 0 0 0 0 13 16 16 16 16 16 16 16 16 16 16 16 16 16 16 16 16 16 16 16 16
16 16 16 16 13 13 0 0 0 0 0 0 0 0 0 0 0 0 0 0 13 13 13 13 13 13 13 13 13 16 16 16 16 16 16 16 16 16 16 16 16 16 16 16 16 16 16 16 16 16
16 16 16 16 16 16 13 13 13 13 13 13 13 13 13 13 13 13 13 13 16 16 16 16 16 16 16 16 16 16 16 16 16 16 16 16 16 16 16 16 16 16 16 16 16 16 16 16 16 16
16 16 16 16 16 16 16 16 16 16 16 16 16 16 16 16 16 16 16 16 16 16 16 16 16 16 16 16 16 16 16 16 16 16 16 16 16 16 16 16 16 16 16 16 16 16 16 16 16 16
16 16 16 16 16 16 16 16 16 16 16 16 16 16 16 16 16 16 16 16 16 16 16 16 16 16 16 16 16 16 16 16 16 16 16 16 16 16 16 16 16 16 16 16 16 16 16 16 16 16
16 16 16 16 16 16 16 16 16 16 16 16 16 16 16 16 16 16 16 16 16 16 16 16 16 16 16 16 16 16 16 16 16 16 16 16 16 16 16 16 16 16 16 16 16 16 16 16 16 16
16 16 16 16 16 16 16 16 16 16 16 16 16 16 16 16 16 16 16 16 16 16 16 16 16 16 16 16 16 16 16 16 16 16 16 16 16 16 16 16 16 16 16 16 16 16 16 16 16 16
16 16 16 16 16 16 16 16 16 16 16 16 16 16 16 16 16 16 16 16 16 16 16 16 16 16 16 16 16 16 16 16 16 16 16 16 16 16 16 16 16 16 16 16 16 16 16 16 16 16
